#Example: Large parts of Africa and south east Asia
tropical = {
3901 3902 3905 3906 3907 3908 3909 3910 3911 3912 3913 3914 3915 3917 3918 3928 3929 3930 3931 3932 3934 3935 3936 3937 3938 3939 3940 3941 3942 3943 3944 3945 3946 3947 3948 3949 3950 3951 3952 3953 3954 3955 3956 3957 3958 3959 3960 3961 3962 3963 3964 3979 3986 3987 3989 3990 3991 3992 3993 3994 3995 3996 3998
3747 3748 3749 3750 3751 3752 3753 3754 3755 3756 3757 3758 3759 3760 3761 3809 3812 3839 3840 3841 3842 3843 3844 3845 3846 3847 3848 3849 3850 3851 3852 3853 3854 3855
3659 3660 3663 3666
3238 3239 3265 3266 3267 3268 3269 3270 3283 3291 3292 3293

3244 3245
2874 2875 2876 2877 2878 2879 2880 2881

2570 2571 2578 2579
2278 2350 2351 2352 2353 2354 2355 2356 2357 2358 2359 2362 2363
2049 2060 2061 2062 2063 2064 2067 2068 2070 2071 2072 2073 2074 2075 2078 2100 2101 2102 2103 2104 2105 2106 2107 2108 2109 2110 2111 2112 2113 2115 2116 2117 2119 2120 2121 2122 2123 2124 2130 2131 2132 2133 2134 2135 2136 2137 2138 2139

	1465 2 420 1058 1496
	1506 1507 1508 1509
	2254
	
	722 723 724 725  727 728 729 734 730 731 732 733 726 735 736 737 738 739 740 741 742 743
	744 745 746 747 748  750 751 752
	1533 1538 1539 1540 1958 1959 1960 1962 1963 1964 1965 1966 1967 1968 1969 1971 1973 1974 1975 1976 1977 1978 1982 1983 1984 1986 1987 1988 1991 1992 1993 1994 1997 1998 1999 2000 2001 2002 2003 2004 2005 2006
	1295 1296 1297 1298 1299 1300 1301 1302 1303 1304 1306 1308 1310 1311 1312 1313 1314 1318 1319 1320 1321 1322 1323 1324 1328 1330 1331 1332 1333 1334 1335 1336 1337 1338 1339 1340 1341 1342 1346 1347 1351 1352 1353 1355 1356 1357 1359 1360 1374 1377
	# Southwest Africa
	        528 529 
	 703 702 704 711 707 706
	 2196 2197 2198 2199 2218 2244
	 2191 2192 2193 2195 2200 2204 2205 2206 2207 2208 2209 2210 2211 2215 2216 2217 2219 2221 2222 2223 2224 2225 2226 2227 2228 2229 2230 2232 2233 2234 2236 2237 2238 2239 2240 2241 2242 2243 2245 2246 2247 2248 2250 2251 2252 2253 2255 2256 2257 2258 2259
	 
	# North and West Africa
	         
	           
	           
	# More West Africa
	              
	            
	# Africa
	               
	# India
	                              
	                              
	                 
	            
	#China
	             
	# Pacific Islands
	                     
	              
	# Indonesia
	                           
	              
	                
	                
	#More Indonesia
	                   
	                  
	     
	         #Philippine additions
	# Parts of Australia
	   
	# Amazonas and others
	                                        
	    #Rio Grande
	       #Minas Gerais
	      #Goias
	   #Mato Grosso
	      #Sao Paolo
	      #Bahia
	      #Maranhao
	               #Venezuela
	  #New Andalucia
	     #Guyana
	 
	#Central America
	        
	           
	
	# South East Asia
	            
	                             
	          
	# Wasteland
	        
	
	                            
	                     
	      
}

arid = {
3406 3410 3411 3412 3413 3414 3415
3295 3296 3297 3298
2638 2855 2956 2957 2969 3046 3047 3048 3137 3138 3140 3141 3142 3143 3144 3145 3146
2533 2534 2552 2553 2554 2555 2562 2566
7 20 1520 1592 1870 2277 2295 2327 2367 2374 2376 2377 2378 2379 2380 2381 2382 2383 2384 2386 2392 2393 2394 2395 2449 2450 2451 2452 2453 2454 2455 2456 2457 2458 2459 2460 2461 2462 2463 2464 2465 2466 2467 2468 2469 2470 2471 2472 2473 2474 2475 2476 2477 2478 2479 2480 2481 2482 2483 2484 2485 2486 2487 2488 2489 2490 2491 2492 2493 2494 2495 2496 2497 2498 2499 2500 2502 2503 2504 2505 2506 2507 2508 2509 2510 2511 2512 2513 2514 2515 2516 2517 2518 2519 2520 2521 2522 2523 2524 2525 2526 2527 2528 2530 2531 2532 2536 2538
2069 2263 2264 2265 2266 2267 2268 2269 2270 2271 2272 2274 2275 2276
2050 2051 2052 2053 2054 2055 2056 2057 2065
1547 1590 1732 1734 1810 1995 1996 2007 2008 2022 2023 2024 2025 2026 2027 2033 2034 2037 2039 2040 2041 2042 2045 2046 2047 2048

1376 1515 1516 1517 1518 1521 1522 1523 1524 1525 1526 1527 1528 1529 1530 1531 1532 1534 1535 1550 1551 1552 1553 1556 1557 1558 1559 1560 1561 1562 1563 1564 1565 1566 1567 1568 1569 1570 1571 1572 1573 1574 1575 1576 1577 1578 1579 1580 1581 1582 1583 1584 1585 1586 1587 1588 1589 1591 1593 1594 1595 1596 1597 1598 1599 1600 1601 1602 1603 1604 1605 1606 1607 1608 1609 1610 1613 1614 1615 1616 1617 1618 1619 1620 1633 1634 1635 1637 1658 1659 1660 1661 1662 1663 1690 1691 1692 1693 1694 1695 1696 1697 1698 1699 1700 1712 1713
1343 1344 1345 1348 1349 1368 1375 1378 1379 1380 1381 1382 1383 1384 1385 1386 1388
	502 501 513 517 518 537 539 492 474 
	480 448 487 482 481 496 495 494 499 490 
	940 941 942 992 1730 1731 1735 1737 1738 1746 1747 1748 1752 1757 1758 1759 1760 1761 1763 1765 1772 1773 1774 1775 1776 1777 1778 1779 1780 1781 1783 1784 1785 1786 1787 1788 1789 1790 1791 1806 1814 1815 1823 1827 1828 1830 1834 1835 1846 1847 1848 1849 1850 1851 1852 1853 1854 1855 1856 1857 1858 1859 1860 1864 1865 1866 1867 1868 1869  1915 1916 1917 1918 1919
}

arctic = {
9 3593 3727 3728 3729 3730 3731 3732 3733 3734 3735 3736 3737 3738 3739 3740 3741 3742 3743 3744 3745 3746
3416 3419 3420 3421 3422 3423 3424 3425 3426 3428 3429 3430 3434 3437 3441 3442 3445 3448 3449 3452 3453 3454 3455 3456 3457 3458 3460 3461 3463 3464 3465 3466 3467 3468 3469 3470 3473 3475 3476 3477 3478 3479 3480 3481 3482 3483 3484 3485 3486 3487 3488 3489 3490 3491 3492 3493 3494 3495 3496
3498 3500 3501 3502 3503 3504 3505 3506 3507 3508 3509 3510 3511 3512 3513 3514 3515 3516 3517 3518 3519 3520 3521 3522 3523 3524 3525 3531 3532 3533 3534 3535 3536 3537 3538 3539 3540 3541 3542 3543 3544 3545 3546 3547 3548 3549 3550 3551 3552 3553 3554 3555 3556 3557 3558 3559 3560 3561 3562 3563 3564 3565 3566 3567 3568 3569 3570 3571 3572 3573 3574 3575 3576 3577 3578 3579 3580 3581 3582 3583 3584 3585 3586 3587 3588 3589 3590 3591 3592 3594 3595 3596 3597 3598 3599 3600 3601 3602 3603 3604 3605 3606 3607 3608 3609  3613 3614 3615 3616 3617 3618 3619 3620 3621 3622 3623 3625 3626 3627 3628 3629 3631 3632 3633 3634 3635
3386 3387 3388 3389 3352 3353 3354 3355 3356 3357 3360 3363 3364 3374 3380 3381 3382
3198 3304 3305 3306 3310 3314 3315 3316 3317 3318 3319 3323 3324 3342 3344 3345 3346 3347 3348 3349 3350 3351
2904 2921 2930 2931 2932 2938 2940 2953 2954 2955 2958 2960 2962 2963 2964 2976 2977 2988 2998
2885 2886 2887 2888 2889 2890 2891 2892 2893
1889 1892 1894 1895 1899 1900 1908 1909 1910 1913
1666 1667 1668 1669 1670 1671 1672 1673 1674 1675 1676 1677 1678 1679 1680 1709 1710
1228 1407 1445 1446 1447 1448
1260 1397 1398 1399 1400 1401 1402 1403 1404 1405 1406  1412 1413 1414 1418 1419 1420 1421 1422 1423 1424 1425 1426 1428 1431 1432 1433 1434 1435
1254 1220 1218 1221 1211 1204 1229 1262 1261 1263 230 1316 1329
1198 1205 1206 1209 1210 1216 1219 1222 1223 1233 1244 1245 1247 1248 1251 1264
1158
		1148 1149 1150 1151 1152 1153 1154 1155 1156 1157  1159 1160 1161 1162 1163 1164 1165 1166 1167 1168 1169 1170 1128 1129 1130 1131 1132 1133 1134 1135 1136 1137 1138 1139 1140 1141 1142 1143 1144 1145 1146 1147 
	
1091 1093 1095 1096
1080 1081 1082 1083 1084 1085 1086 1087 1088 1089 1090 1094 1099 1100 1101 1102 1103 1109 1110 1111 1112 1113 1114 1115 1116 1117 1118 1123
 240 243 260 259 257 269 270 271 231 261 264 262 275 279 280 292
 
 804 805 806 807 999
1044 1045 1046 1047 1048 1049 1050 1051 1052 1053 1054 1055 1056 1057 1059 1060 1061 1062 1063 1064 1065 1066 1067 1068 1069
}

#Example: Most of Europe north of med.
mild_winter = {
3378 3379 3408 3409 3967 3969 3970 3971 3972 3976 3981 3982 3983 3984
2537 3321 3322 3325 3326 3327 3328 3329 3330 3331 3332
3271 3272 3273 3274 3275 3276 3277 3278 3279 3280
3026 3027 3028
3039 3050 3051 3052 3053 3055 3060 3062 3120
2882 2896 2897 2899 2900 2901 2999 3000 3002 3003 3004 3005 3009 3013 3015

2828 2829 2830 2831 2832 2833 2834 2835 2836 2837 2838 2839
2619 2620 2621 2622 2623 2624 2625 2626 2627 2628 2630 2631 2632 2633 2634 2636 2639 2640 2641 2642 2643 2646 2647 2648 2649 2650 2651 2653 2656 2661 2662 2663 2664 2665 2666 2675 2676 2677 2678 2679 2680 2681 2682 2683 2684 2685 2686 2687 2688 2690 2691 2692 2693 2694 2695 2696 2697 2699 2700 2701 2702 2703 2705 2706 2707 2712 2713 2714 2715 2716 2717 2718 2719 2720 2721 2722 2724 2725 2726 2727 2728 2729 2730 2731 2732 2733 2734 2735 2738 2739 2751 2752 2753 2755 2756 2757 2758 2759 2760 2761 2762 2763 2764 2767 2772 2775 2776 2778 2779 2782 2801 2803 2808 2809 2810 2811 2812 2813 2826 2827
2396 2399 2400 2402 2403 2405 2407 2408 2409 2412 2419 2420 2422 2423 2424 2425 2426 2428 2429 2430 2431 2432 2433 2434 2435 2436 2437 2438 2439 2440 2441 2442 2443 2444 2446
2113 2114 2125 2127 2129
1832 1833 1871 1872 1873 1875
1600 1601 1602 1603 1613 1614 1615 1616 1662 1663 1690 1691 1692 1693 1694 1695 1696 1697 1698 1699 1700 1723 1724
1354 1364 1373
1256 1258 1259
783 785 786 787 788 789 790 791 792 793 794 795 796 798 809 810 811 814 815 816 817 818 823 824 825 826 827 828 829 830 832 851 858 859 860 861 862 866 867 874 875 877 878 879 880 881 882 895 899 900 902 903 920 921 922 923 924 925 926 927 929 930 940 941 944 955 956 957 958 959 960 961 964 965 966 967 968 969 970 971 973 974 975 977 978 979 980 981 982 983 984 985 986 987 988 989 990 992 993 994 995

559 549 644 645 568 567 570 373 374 375 377 378 379 380 381 392 393 394 396 547 548 550 557
	107 87 105 91 84 73 86 70 72 116 77 76 49 45 47 46 43 42 38 36 35 30 23 25 28 37 48 80 31 303 304 305 306 308 309 310 311 315 316 312 318 319 313 331 330 328 329 336 338  335 334 333 332 382 384 383 385 386 387 388 389 390 391 405 402 404 406 403
}

#Example: Inland Europe & Scandinavia
normal_winter = {
2840 3365 3407
3213 3309 3311 3333 3334 3336 3337 3339
3037 3038 3054 3057 3058 3061
3010 3018 13 3049 3059 3063 3064 3065 3066 3067 3071 3073 3075 3076 3077 3078 3091 3092 3093 3094 3095 3096 3097 3098 3099 3100 3101 3102 3103 3104 3105 3106 3107 3108 3109 3115 3116 3117 3118 3119 3121 3122 3123 3124 3125 3126 3127 3128 3129 3130 3131 3132
2902 2903 2905 2907 2908 2909 2910 2911 2912 2913 2934 2935 2947 2966 2968 2970 2978 2981 2996 2997 3001 3006 3007 3008 3011 3012 3014 3016 3017 3019 3020 3022 3023 3024 3025
2723 2824 2825 2883 2884
2608 2613 2614 2629 2635 2637 2644 2736 2737 2740 2741 2742 2743 2744 2745 2746 2747 2748 2749 2750 2754 2765 2766 2768 2769 2770 2771 2773 2774 2777 2780 2781 2783 2784 2785 2786 2787 2788 2789 2790 2791 2792 2793 2794 2795 2796 2797 2798 2799 2800 2804
2126 2128
2445 2447 2448
1837 1839 1840 1841 1842 1844 1845 1874 1878 1881 1883 1884 1885 1887 1888
1604 1605 1606 1607 1608 1609 1610 1617 1618 1619 1620 1621 1622 1623 1624 1628 1633 1634 1635 1637 1654 1655 1656 1657 1658 1659 1660 1661 1687 1688 1689 1701 1702 1703 1704 1705 1712 1713
1305 1307 1309 1315 1317 1362 1365
1415 1416 1436 1438 1439 1440 1441 1442 1443 1444 1449 1450 1453 1454 1456 1458 1459 1460 1461 1462 1463 1464
307 1193 1194 1195 1196 1197 1199 1200 1217
	554 551 552 556 558  508 509 716 715 713
	98 97 99 108 69 67 112 101 113 111 109 68 102 104 103 66 65 56 55 57 58 50 51 74 75 100 106 115 117 114 40 44 110 41 24 26 
	232 235 236 237 238 244 245 246 247 248  233 234 239  241 242 139    176 277 278       314 
	
	763 764 765 766 767 768 769 770 771 772 774 778 780 782 784 799 801 802 808 812 813 831 850 852 856 857 873 883 962
	797 800 803 846 848 849 853 876 884 890 892 894 896 897 898 901 913 914 915 916 917 918 919 934 935 936 937 938 939 942 943 945 946 947 948 949 951 952 953 954 963 972 991 997 998
}

#Example: Russia & Lappland
severe_winter = { 
9 3593 3727 3728 3729 3730 3731 3732 3733 3734 3735 3736 3737 3738 3739 3740 3741 3742 3743 3744 3745 3746
3526 3527 3528 3529 3530 3610 3611 3612 3624
3498 3500 3501 3502 3503 3504 3505 3506 3507 3508 3509 3510 3511 3512 3513 3514 3515 3516 3517 3518 3519 3520 3521 3522 3523 3524 3525  3531 3532 3533 3534 3535 3536 3537 3538 3539 3540 3541 3542 3543 3544 3545 3546 3547 3548 3549 3550 3551 3552 3553 3554 3555 3556 3557 3558 3559 3560 3561 3562 3563 3564 3565 3566 3567 3568 3569 3570 3571 3572 3573 3574 3575 3576 3577 3578 3579 3580 3581 3582 3583 3584 3585 3586 3587 3588 3589 3590 3591 3592 3594 3595 3596 3597 3598 3599 3600 3601 3602 3603 3604 3605 3606 3607 3608 3609  3613 3614 3615 3616 3617 3618 3619 3620 3621 3622 3623 3625 3626 3627 3628 3629 3631 3632 3633 3634 3635
3416 3418 3419 3420 3421 3422 3423 3424 3425 3426 3427 3428 3429 3430 3431 3432 3433 3434 3435 3436 3437 3438 3439 3440 3441 3442 3443 3444 3445 3446 3447 3448 3449 3450 3452 3453 3454 3455 3456 3457 3458 3459 3460 3461 3462 3463 3464 3465 3466 3467 3468 3469 3470 3471 3472 3473 3475 3476 3477 3478 3479 3480 3481 3482 3483 3484 3485 3486 3487 3488 3489 3490 3491 3492 3493 3494 3495 3496 3497
3304 3305 3306 3307 3308 3310 3312 3313 3314 3315 3316 3317 3318 3319 3320 3323 3324 3338 3340 3341 3342 3343 3344 3345 3346 3347 3348 3349 3350 3351
3286 3287 3288 3289 3290 3335
3352 3353 3354 3355 3356 3357 3358 3359 3360 3361 3362 3363 3364 3366 3367 3368 3369 3370 3371 3372 3373 3374 3375 3376 3377 3380 3381 3382 3383 3384 3385 3386 3387 3388 3389 3391 3392 3393 3404

3198 
3031 3032 3033 3034 3035 3036 3040 3041 3042 3043 3045 3056 3068 3069 3070 3072 3074 3079 3080 3081 3082 3083 3084 3085 3086 3087 3088 3089 3090 3110 3111 3112 3113 3114 3133 3134
2898 2904 2906 2914 2915 2916 2917 2918 2919 2920 2921 2922 2923 2924 2925 2926 2927 2928 2929 2930 2931 2932 2933 2936 2937 2938 2939 2940 2941 2942 2943 2944 2945 2946 2948 2949 2950 2951 2952 2953 2954 2955 2958 2959 2960 2961 2962 2963 2964 2965 2967 2971 2972 2973 2974 2975 2976 2977 2979 2980 2982 2983 2984 2985 2986 2987 2988 2989 2990 2991 2992 2993 2994 2995 2998 3021
2885 2886 2887 2888 2889 2890 2891 2892 2893
2814 2815 2816 2817 2818 2819 2820 2821 2822 2823
1836 1838 1843 1876 1877 1879 1880 1882 1886 1889 1890 1891 1892 1893 1894 1895 1896 1897 1898 1899 1900 1901 1902 1903 1904 1905 1906 1907 1908 1909 1910 1911 1912 1913
 891 1625 1626 1627 1629 1630 1631 1632 1636 1638 1639 1640 1641 1642 1643 1644 1645 1646 1647 1648 1649 1650 1651 1652 1653 1666 1667 1668 1669 1670 1671 1672 1673 1674 1675 1676 1677 1678 1679 1680 1681 1682 1683 1684 1685 1686 1706 1707 1708 1709 1710 1714 1715 1716 1717 1718 1719
1397 1398 1399 1400 1401 1402 1403 1404 1405 1406 1407 1408 1409 1410 1411 1412 1413 1414 1417 1418 1419 1420 1421 1422 1423 1424 1425 1426 1427 1428 1429 1430 1431 1432 1433 1434 1435 1437 1445 1446 1447 1448
1451 1452 1455 1457
1257 1224 1316 1329
1198 1201 1202 1203 1204 1205 1206 1207 1208 1209 1210 1211 1212 1213 1214 1215 1216 1218 1219 1220 1221 1222 1223 1225 1226 1227 1228 1229 1230 1231 1232 1233 1234 1235 1236 1237 1238 1239 1240 1241 1242 1243 1244 1245 1246 1247 1248 1249 1250 1251 1252 1253 1254 1255 1260 1261 1262 1263 1264 1287
1268 1269 1270 1271 1272 1273 1274 1275 1276 1277 1278 1279 1280 1281 1282 1283 1284 1285 1286 1289 1290 1292 1293 1294 1394 1395 1396 1612 1664 1665 1711

		1148 1149 1150 1151 1152 1153 1154 1155 1156 1157  1159 1160 1161 1162 1163 1164 1165 1166 1167 1168 1169 1170 1128 1129 1130 1131 1132 1133 1134 1135 1136 1137 1138 1139 1140 1141 1142 1143 1144 1145 1146 1147 
	1158

1080 1081 1082 1083 1084 1085 1086 1087 1088 1089 1090 1091 1092 1093 1094 1095 1096 1097 1098 1099 1100 1101 1102 1103 1104 1105 1106 1107 1108 1109 1110 1111 1112 1113 1114 1115 1116 1117 1118 1119 1120 1121 1122 1123

1039 1040 1041 1042 1043
1037 1038
1074 1075 1076 1078 1077
1069 1070 1071 1072 1073
1064 1065 1066 1067 1068
1059 1060 1061 1062 1063
1054 1055 1056 1057
1049 1050 1051 1052 1053
1044 1045 1046 1047 1048
1000 1001 1002 1003 1004 1005 1006 1007 1008 1009 1010 1011 1012 1013 1014 1015 1016 1017 1018 1019 1020 1021 1022 1023 1024
1025 1026 1027 1028 1029 1030 1031 1032 1033 1034 1035 1036
781 833 893 933
804 805 806 807 834 835 836 837 838 839 840 841 842 843 844 845 847 854 855
773 775 776 777 779 885 886 887 888 889 904 905 906 907 908 909 910 911 912 950 999

 714
272 273 274 275 276
  279 280 281
282 283 284
285 286 287 288
289 290 291 292
293 294 295 296 301
297 298 299 300 302

	120 121 122 123 124 125 126 127 128 129 130
	96 95 60 62 64 63 61 59 52 53 54 71 
	249 250 251 252
	253 254 255 256
	257 258 259 260
	261 262 263 264
	265 266 267 268
	269 270 271 231
	225 226 227 228
	229 230 224 240 243 153 136 555 553 
}

impassable = {
3926 3973 3974 3975
3873 3874 3875 3876 3877 3878 3879 3880 3881 3882 3883 3884 3885 3886 3887 3888 3889 3890 3891 3892 3893 3894 3895 3896 3897 3898 3899
3499 3593 
3417 3451 3474 3390 
 3394 3395 3396 3397 3398 3399 3400 3401 3402 3403
3286 3287 3288 3289 3290 3299 3198 3200
2894 2892 2893 3029 3030 3044
2366 2805 2806 2807
2501 2447 2448
8 1 3 4 5 6 8 10 11 12 14 15 16 19 21 118
2058 2059 2066 2140 2141 2142 2146 2147 2148 2149 2150 2151
2262
1961 2044

1901 1902 1903 1914
9 10
1720 1721 1722 1723 1724 1725 1726 1727 1728 1664 1665

1536  1711 1612
1289 1290 1291 1292 1293 1294 1394 1395 1396
1037 1038
	          119 120 121 122 123 124 125 126 127 128 129 130              
	                          717
								
	               176      488 486   
	      22
	
	   544 545 546 781
	   933 893 
	   833
	         
			 1268 1269 1270 1271 1272 1273 1274 1275 1276 1277 1278 1279 1280 1281 1282 1283 1284 1285 1286
}

mild_monsoon = {
3238 3239 3265 3266 3267 3268 3269 3270 3283 3285 3291 3292 3293
2645 3217 3218 3219 3220 3224 3226 3227 3228 3229 3230 3231 3232 3233 3234 3235 3236
2570 2571 2572 2573 2574 2575 2576 2577 2578 2579 2580
2302 2303 2330 2331 2332 2333 2337 2338 2339 2340 2342 2347 2348 2349
2278 2350 2351 2352 2353 2354 2355 2356 2357 2358 2359 2362 2363
2203 2214 2228 2230 2231 2241 2242 2243 2244 2245 2246 2247 2248 2249

2067 2068 2111 2112 2113 2115 2116 2117 2119 2121 2122 2127 2129
1301 1302 1305 1306 1307 1308 1309 1310 1311 1313 1314 1315 1317 1318 1319 1320 1321 1322 1323 1324 1325 1326 1327 1328 1329

	93 94 456 475 472 467 455 477 476 473 520 521 516 518 537 613 612 609 621 622
	625 643 649 658 659 665 672 673 674 675 678 679 687 699 700 712 713 714 715
	760 761 762
}

normal_monsoon = {
2194 2201 2202 2210 2211 2212 2213 2219 2220 2221 2222 2223 2224 2225 2226 2227 2229 2232 2233 2234 2235 2236 2237 2238 2239 2240
2064 2075 2078 2079 2095 2097 2099 2120 2123 2124 2130
1330 1331 1332 1333 1334 1335 1336 1337 1338 1339 1340 1341 1342 1343 1344 1345 1346 1347 1348 1349 1350 1351 1352 1353

	168 169 170 171 191 192 193 531 532 530 529 527 526 525 519 619 620 598
	661 662 664 666 670 671 676 677 680 681 682 701 708 709 710 
	748 751 750 749
	
	1533 1538 1539 1540 1958 1959 1960 1962 1963 1964 1965 1967 1968 1969
}

severe_monsoon = {
2191 2192 2193 2195 2196 2197 2198 2199 2200 2204 2205 2206 2207 2208 2209 2215 2216 2217 2218 2250 2251 2252 2253 2254 2255 2256 2257 2258 2259 2265 2266
2060 2061 2062 2063 2070 2071 2072 2073 2074 2100 2101 2102 2103 2104 2105 2106 2107 2108 2109 2131 2132 2133 2134 2135 2136 2137 2138 2139
1506 1507 1508 1509 1465 2 420 1058 1496
3245 3244

	     194 167 528 524 523 614 616 615 617 618 669 667 668 663 685 683 684 686 705 706 707 702 703 704 721 718 719 720
	               
				   	722 723 724 725  727 728 729 734 730 731 732 733 726 735 736 737 738 739 740 741 742 743
	744 745 746 747    752
}

equator_y_on_province_image = 656
