width = 5632
height = 2048



max_provinces = 4108
sea_starts = { 

4002 4003 4004 4005 4006 4007 4008 4009 4010 4011 4012 4013 4056 4057 4058 4059 4060 4061 4062 4063 4064 4065 4066 4067 4068 4069 4070 4071 4072
3857 3858 3859 3860 3861 3862 3863 3864 3865 3866 3867 3868 3869 3870 3871 3872
3762 3763 3764 3765 3766 3767 3768 3769 3770 3771 3772 3773 3774 3775 3776 3777 3778 3779 3780 3781 3782 3783 3784 3785 3786 3787 3788 3789 3790 3791 3792 3793 3794 3795 3796 3797 3798 3799 3800 3801 3802 3803 3804 3805 3806 3807 3808
3726
18 3700 3701 3702 3703 3704 3705 3706 3707 3708 3709 3710 3711 3712 3713 3714 3715 3716 3717       
3630 3636 3637 3638 3639 3640 3641 3642 3643 3644 3645 3646
3246 3247 3248 3249 3250 3251 3252 3253 3254 3255 3256 3257 3258 3259 3260 3261 3262 3263 3264 
3240 3241 3242 3243
3668 3669 3670 3671 3672 3673 3674 3675 3676 3677 3678 3679 3680 3681 3682 3683 3684 3685 3686 3687 3688 3689 3690 3691 3692 3693 3694 3695 3696 3697 3698 3699 3718 3719 3720 3721 3722 3723 3724 3725
3147 3148 3149 3150 3151 3152 3153 3154 3155 3156 3157 3158 3159 3160 3161 3162 3163 3164 3165 3166 3167 3168 3169 3170 3171 3172 3173 3174 3175 3176 3177 3178 3179 3180 3181 3182 3183 3184 3185 3186 3187 3188 3189 3190 3191 3192 3193 3194 3195 3196 3197
2592 2593 2594 2595 2597 2598 2599 2600 2601 2602 2603 2604 2596
2181 2182 2183 2184
2185 2186 2187 2188 2189 2190 2175 2176 2177 2178 2179 2180
2152 2153 2154 2155 2156 2157 2174
2158 2159 2160 2161 2162 2163 2164 2165
2166 2167 2168 2169 2170 2171 2172 2173
1943 1944 1945 1946 1947 1948 1949 1950 1951 1952 1953 1954 1955 1956 1957 
1930 1931 1932 1933 1934 1935 1936 1937 1938 1939 1940 1941 1942 1921 
1922 
1923
1924 1925 1926 1927 1928 1929
1389 1390 1391 1729
1476 1477 1478 1479 1480 1481 1482 1483 1484 1485 1486 1487 1488 1489 1490 1491
1492 1493 1494 1495 1497 1498 1499 1500 1501 1502 1503 1504 1505
1466 1467 1468 1469 1470 1471 1472 1473 1474 1475
 206 207 208 209 210 211 212 213 214 215 216 217 218 219 220 221 222 223
 
 423 424 425 426 427 428 429 430 431 432 433 434 435 436 437 438 439 440 441 442 443
 407 408 409 410 411 412 413 414 415 416 417 418 419 421 422 444 445
 
 1171 1172 1173 1174 1175 1176 1177 1178 1179 1180 1181 1182 1183 1184 1185 1186 1187 1188 1189 1190
1191 1192
	753 754 755 756 757 758 759 

	2841 2842 2843 2844 2845 2846 2847 2848 2849 2850 2851 2852 2853 2854 2856 2857 2858 2859 2860 2861 2862 2863 2864 2865 2866 2867 2868 2869 2870 2871 2872 2873
}

only_used_for_random = {
}

lakes = {

204 205 996 1124 1125 1126 1127 1265 1266 1267 1288 1392 1393 1554 1555 1611
1754 1755 1756 2021 2143 2144 2145 2260 2261 2605 2606 2607 2895 3199 3201 3300 3301 3302 3303
}

force_coastal = {
}

definitions = "definition.csv"
provinces = "provinces.bmp"
positions = "positions.txt"
terrain = "terrain.bmp"
rivers = "rivers.bmp"
terrain_definition = "terrain.txt"
heightmap = "heightmap.bmp"
tree_definition = "trees.bmp"
continent = "continent.txt"
adjacencies = "adjacencies.csv"
climate = "climate.txt"
region = "region.txt"
superregion = "superregion.txt"
area = "area.txt"
provincegroup = "provincegroup.txt"
ambient_object = "ambient_object.txt"
seasons = "seasons.txt"
trade_winds = "trade_winds.txt"

canal_definition = {
	name = "rheen_canal"
	x = 1353
	y = 664

}

# Define which indices in trees.bmp palette which should count as trees for automatic terrain assignment
tree = { 3 4 7 10 }
